Gene	Transcription Factor	DNA-Binding Feature	Sequence - feature sequence
aaeR	DNA-binding transcriptional activator AaeR	DNA-Binding-Region  19->38 	FTAAARQLQMSVSSISQTVS
acrR	DNA-binding transcriptional repressor AcrR	DNA-Binding-Region  33->52 	SLGEIAKAAGVTRGAIYWHF
ada	DNA-binding transcriptional dual regulator / DNA repair protein Ada	DNA-Binding-Region  102->121 	LEALADQVAMSPFHLHRLFK
adiY	DNA-binding transcriptional activator AdiY	DNA-Binding-Region  166->187 	SMVASCLCLSPSLLKKKLKSEN
adiY	DNA-binding transcriptional activator AdiY	DNA-Binding-Region  213->236 	ISQVSQSCGYNSTSYFISVFKDFY
agaR	DNA-binding transcriptional repressor AgaR	DNA-Binding-Region  32->51 	VQVNDLSALYGVSTVTIRND
aidB	putative acyl-CoA dehydrogenase AidB	DNA-Binding-Region  440->541 	NKQAGVYDLLSEAFVEVKGQDRYFDRAVRRLQQQLRKPAEELGREITHQLFLLGCGAQMLKYASPPMAQAWCQVMLDTRGGVRLSEQIQNDLLLRATGGVCV
allR	DNA-binding transcriptional repressor AllR	DNA-Binding-Region  43->62 	VSDISLNLDLPLSTTFRLLK
allS	DNA-binding transcriptional activator AllS	DNA-Binding-Region  19->38 	FSKAAERLCKTTATISYRIK
alpA	CP4-57 prophage; DNA-binding transcriptional activator AlpA	DNA-Binding-Region  12->31 	LPAVIQKTGMARATIYDWLN
alsR	DNA-binding transcriptional repressor AlsR	DNA-Binding-Region  50->69 	IKDVAEALAVSEAMIVKVSK
appY	DLP12 prophage; DNA-binding transcriptional activator AppY	DNA-Binding-Region  156->177 	KDIAELIYTSESLIKKRLRDEG
appY	DLP12 prophage; DNA-binding transcriptional activator AppY	DNA-Binding-Region  203->226 	INVVAQKCGYNSTSYFICAFKDYY
araC	AraC	DNA-Binding-Region  198->219 	ASVAQHVCLSPSRLSHLFRQQL
araC	AraC	DNA-Binding-Region  246->269 	IATVGRNVGFDDQLYFSRVFKKCT
arcA	DNA-binding transcriptional dual regulator ArcA	DNA-Binding-Region  134->234 	VESYKFNGWELDINSRSLIGPDGEQYKLPRSEFRAMLHFCENPGKIQSRAELLKKMTGRELKPHDRTVDVTIRRIRKHFESTPDTPEIIATIHGEGYRFCG
argP	DNA-binding transcriptional dual regulator ArgP	DNA-Binding-Region  21->40 	FERAAQKLCITQSAVSQRIK
arsR	DNA-binding transcriptional repressor ArsR	DNA-Binding-Region  33->52 	VCDLCTALDQSQPKISRHLA
ascG	DNA-binding transcriptional repressor AscG	DNA-Binding-Region  4->23 	MLEVAKRAGVSKATVSRVLS
asnC	DNA-binding transcriptional dual regulator AsnC	DNA-Binding-Region  25->44 	YAELAKQFGVSPGTIHVRVE
atoC	DNA-binding transcriptional activator/ornithine decarboxylase inhibitor AtoC	DNA-Binding-Region  433->452 	RTRTALMLGISRRALMYKLQ
baeR	DNA-binding transcriptional activator BaeR	DNA-Binding-Region  131->234 	QRELQQQDAESPLIIDEGRFQASWRGKMLDLTPAEFRLLKTLSHEPGKVFSREQLLNHLYDDYRVVTDRTIDSHIKNLRRKLESLDAEQSFIRAVYGVGYRWEA
basR	DNA-binding transcriptional dual regulator BasR	DNA-Binding-Region  124->218 	ESELIVGNLTLNMGRRQVWMGGEELILTPKEYALLSRLMLKAGSPVHREILYNDIYNWDNEPSTNTLEVHIHNLRDKVGKARIRTVRGFGYMLVA
betI	DNA-binding transcriptional repressor BetI	DNA-Binding-Region  31->50 	TIAQIARRAGVSTGIISHYF
bglJ	DNA-binding transcriptional regulator BglJ	DNA-Binding-Region  170->189 	MTQIAEQLKRNIKTIRAHKF
birA	DNA-binding transcriptional repressor/biotin-[acetyl-CoA-carboxylase] ligase BirA	DNA-Binding-Region  22->41 	GEQLGETLGMSRAAINKHIQ
bluR	DNA-binding transcriptional repressor BluR	DNA-Binding-Region  6->25 	IGDVAERCGINPVTLRAWQR
cadC	DNA-binding transcriptional activator CadC	DNA-Binding-Region  3->102 	QPVVRVGEWLVTPSINQISRNGRQLTLEPRLIDLLVFFAQHSGEVLSRDELIDNVWKRSIVTNHVVTQSISELRKSLKDNDEDSPVYIATVPKRGYKLMV
cbl	DNA-binding transcriptional activator Cbl	DNA-Binding-Region  19->38 	LTEVANMLFTSQSGVSRHIR
cecR	DNA-binding transcriptional dual regulator CecR	DNA-Binding-Region  33->52 	TTREIAAQAGQNIAAITYYF
chbR	ChbR	DNA-Binding-Region  193->214 	ENMVALSAKSQEYLTRATQRYY
chbR	ChbR	DNA-Binding-Region  241->264 	VTDIAFEAGYSSPSLFIKTFKKLT
comR	DNA-binding transcriptional repressor ComR	DNA-Binding-Region  41->60 	SLADLVEATGAKAPTLYAEF
cpxR	DNA-binding transcriptional dual regulator CpxR	DNA-Binding-Region  131->230 	SPTLEVDALVLNPGRQEASFDGQTLELTGTEFTLLYLLAQHLGQVVSREHLSQEVLGKRLTPFDRAIDMHISNLRRKLPDRKDGHPWFKTLRGRGYLMVS
cra	DNA-binding transcriptional dual regulator Cra	DNA-Binding-Region  3->22 	LDEIARLAGVSRTTASYVIN
creB	DNA-binding transcriptional regulator CreB	DNA-Binding-Region  129->228 	SPVIRIGHFELNEPAAQISWFDTPLALTRYEFLLLKTLLKSPGRVWSRQQLMDSVWEDAQDTYDRTVDTHIKTLRAKLRAINPDLSPINTHRGMGYSLRG
crp	DNA-binding transcriptional dual regulator CRP	DNA-Binding-Region  180->186 	SRETVGR
csgD	DNA-binding transcriptional dual regulator CsgD	DNA-Binding-Region  173->192 	NNEIARSLFISENTVKTHLY
csqR	DNA-binding transcriptional dual regulator CsqR	DNA-Binding-Region  25->44 	MNIDELANLLDVSTQTVRRD
cueR	DNA-binding transcriptional dual regulator CueR	DNA-Binding-Region  4->23 	SDVAKITGLTSKAIRFYEEK
cusR	DNA-binding transcriptional activator CusR	DNA-Binding-Region  125->223 	ESQFQVADLMVDLVSRKVTRSGTRITLTSKEFTLLEFFLRHQGEVLPRSLIASQVWDMNFDSDTNAIDVAVKRLRGKIDNDFEPKLIQTVRGVGYMLEV
cynR	DNA-binding transcriptional dual regulator CynR	DNA-Binding-Region  18->37 	FTRAASALHVSQPALSQQIR
cysB	DNA-binding transcriptional dual regulator CysB	DNA-Binding-Region  19->38 	VSSTAEGLYTSQPGISKQVR
cytR	DNA-binding transcriptional repressor CytR	DNA-Binding-Region  12->31 	MKDVALKAKVSTATVSRALM
dcuR	DNA-binding transcriptional activator DcuR	DNA-Binding-Region  181->200 	TDELANEVNISRVSCRKYLI
decR	DNA-binding transcriptional activator DecR	DNA-Binding-Region  21->40 	LQALAEAVNLTTTPCWKRLK
deoR	DNA-binding transcriptional repressor DeoR	DNA-Binding-Region  22->41 	LHLKDAAALLGVSEMTIRRD
dgoR	DNA-binding transcriptional regulator DgoR	DNA-Binding-Region  31->50 	EAELCEEFATSRNIIREVFR
dicA	DNA-binding transcriptional dual regulator DicA	DNA-Binding-Region  23->42 	QRSLAKALKISHVSVSQWER
dpiA	DNA-binding transcriptional dual regulator DpiA	DNA-Binding-Region  180->199 	AETVAQALTISRTTARRYLE
dsdC	DNA-binding transcriptional dual regulator DsdC	DNA-Binding-Region  32->51 	FALAAEELSLSPSAVSHRIN
ebgR	DNA-binding transcriptional repressor EbgR	DNA-Binding-Region  4->23 	LKDIAIEAGVSLATVSRVLN
envR	DNA-binding transcriptional repressor EnvR	DNA-Binding-Region  33->52 	TLNDIADAANVTRGAIYWHF
envY	DNA-binding transcriptional activator EnvY	DNA-Binding-Region  166->187 	RIVASSLCLSPSLLKKKLKNEN
envY	DNA-binding transcriptional activator EnvY	DNA-Binding-Region  213->236 	ITQVAQLCGYSSTSYFISVFKAFY
evgA	DNA-binding transcriptional activator EvgA	DNA-Binding-Region  161->180 	NNDIAEKMFISNKTVSTYKS
exuR	DNA-binding transcriptional repressor ExuR	DNA-Binding-Region  35->54 	ERFIADEKNVSRTVVREAII
fabR	DNA-binding transcriptional repressor FabR	DNA-Binding-Region  52->71 	SLREVAREAGIAPTSFYRHF
fadR	DNA-binding transcriptional dual regulator FadR	DNA-Binding-Region  34->69 	ERELSELIGVTRTTLREVLQRLARDGWLTIQHGKPT
feaR	DNA-binding transcriptional activator FeaR	DNA-Binding-Region  217->238 	EWIAGETGMSVRSLYRMFADKG
feaR	DNA-binding transcriptional activator FeaR	DNA-Binding-Region  266->289 	LAGIGFHWGFSDQSHFSTVFKQRF
fhlA	DNA-binding transcriptional activator FhlA	DNA-Binding-Region  663->682 	PKGAAQRLGLKRTTLLSRMK
fis	DNA-binding transcriptional dual regulator Fis	DNA-Binding-Region  74->93 	QTRAALMMGINRGTLRKKLK
fnr	DNA-binding transcriptional dual regulator FNR	DNA-Binding-Region  197->216 	RGDIGNYLGLTVETISRLLG
frlR	DNA-binding transcriptional regulator FrlR	DNA-Binding-Region  38->57 	ENELCTQYNVSRITIRKAIS
fucR	DNA-binding transcriptional activator FucR	DNA-Binding-Region  19->38 	LTTEALSEQLKVSKETIRRD
gadE	DNA-binding transcriptional activator GadE	DNA-Binding-Region  133->152 	ESNITSTLNISQQTLKIQKF
gadW	DNA-binding transcriptional dual regulator GadW	DNA-Binding-Region  156->177 	RDIAERMYTSESLIKKKLQDEN
gadW	DNA-binding transcriptional dual regulator GadW	DNA-Binding-Region  203->226 	LHTIAEKCGYSSTSYFINTFRQYY
gadX	DNA-binding transcriptional dual regulator GadX	DNA-Binding-Region  162->183 	ARIASELLMSPSLLKKKLREEE
gadX	DNA-binding transcriptional dual regulator GadX	DNA-Binding-Region  209->232 	IKRVAVSCGYHSVSYFIYVFRNYY
galR	DNA-binding transcriptional dual regulator GalR	DNA-Binding-Region  4->23 	IKDVARLAGVSVATVSRVIN
galS	DNA-binding transcriptional dual regulator GalS	DNA-Binding-Region  4->23 	IRDVARQAGVSVATVSRVLN
gcvA	DNA-binding transcriptional dual regulator GcvA	DNA-Binding-Region  23->42 	FTRAAEELFVTQAAVSHQIK
glaR	DNA-binding transcriptional repressor GlaR	DNA-Binding-Region  29->48 	MSLLTSRYALGVGPLREALS
glcC	DNA-binding transcriptional dual regulator GlcC	DNA-Binding-Region  34->53 	ERRLCEKLGFSRSALREGLT
glnG	DNA-binding transcriptional dual regulator NtrC	DNA-Binding-Region  445->464 	KQEAARLLGWGRNTLTRKLK
glrR	DNA-binding transcriptional activator GlrR	DNA-Binding-Region  414->433 	VTHAARMAGRNRTEFYKLLS
gntR	DNA-binding transcriptional repressor GntR	DNA-Binding-Region  8->27 	LQDVADRVGVTKMTVSRFLR
gutM	DNA-binding transcriptional activator GutM	DNA-Binding-Region  23->29 	QISRFNR
hcaR	DNA-binding transcriptional dual regulator HcaR	DNA-Binding-Region  18->38 	FTRAAEKLHTSQPSLSSQIRD
hdfR	DNA-binding transcriptional dual regulator HdfR	DNA-Binding-Region  18->37 	FGRAAESLYLTQSAVSFRIR
hicB	antitoxin of the HicA-HicB toxin-antitoxin system /  DNA-binding transcriptional repressor HicB	DNA-Binding-Region  93->112 	QQELARRIGKPKQEITRLFN
higA	antitoxin/DNA-binding transcriptional repressor HigA	DNA-Binding-Region  95->114 	LSDLPEIGSKSMVSRVLSGK
hipA	serine/threonine-protein kinase toxin HipA	DNA-Binding-Region  379->382 	KVLR
hipB	antitoxin/DNA-binding transcriptional repressor HipB	DNA-Binding-Region  21->47 	RQQNGWTQSELAKKIGIKQATISNFEN
hns	DNA-binding transcriptional dual regulator H-NS	DNA-Binding-Region  112->117 	QGRTPA
hprR	DNA-binding transcriptional dual regulator HprR	DNA-Binding-Region  122->220 	NSTLEISGLRMDSVSHSVSRDNISITLTRKEFQLLWLLASRAGEIIPRTVIASEIWGINFDSDTNTVDVAIRRLRAKVDDPFPEKLIATIRGMGYSFVA
hyfR	DNA-binding transcriptional activator HyfR	DNA-Binding-Region  641->660 	PRGAATRLGMKRTTLLSRMQ
hypT	DNA-binding transcriptional dual regulator HypT	DNA-Binding-Region  28->47 	FSQAAVSRNVSQPAFSRRIR
iclR	DNA-binding transcriptional repressor IclR	DNA-Binding-Region  46->65 	LTELAQQAGLPNSTTHRLLT
idnR	DNA-binding transcriptional dual regulator IdnR	DNA-Binding-Region  8->27 	LQDIATLAGVTKMTVSRYIR
ilvY	DNA-binding transcriptional dual regulator IlvY	DNA-Binding-Region  18->37 	FGRSARAMHVSPSTLSRQIQ
iscR	DNA-binding transcriptional dual regulator IscR	DNA-Binding-Region  28->51 	LADISERQGISLSYLEQLFSRLRK
kdgR	DNA-binding transcriptional repressor KdgR	DNA-Binding-Region  34->53 	ITELSQRVMMSKSTVYRFLQ
kdpE	DNA-binding transcriptional activator KdpE	DNA-Binding-Region  126->225 	DPLVKFSDVTVDLAARVIHRGEEEVHLTPIEFRLLAVLLNNAGKVLTQRQLLNQVWGPNAVEHSHYLRIYMGHLRQKLEQDPARPRHFITETGIGYRFML
lacI	DNA-binding transcriptional repressor LacI	DNA-Binding-Region  6->25 	LYDVAEYAGVSYQTVSRVVN
leuO	DNA-binding transcriptional dual regulator LeuO	DNA-Binding-Region  39->58 	ITRAAHVLGMSQPAVSNAVA
lexA	DNA-binding transcriptional repressor LexA	DNA-Binding-Region  28->48 	RAEIAQRLGFRSPNAAEEHLK
lldR	DNA-binding transcriptional dual regulator LldR	DNA-Binding-Region  34->53 	ERQLAMQLGVSRNSLREALA
lrhA	DNA-binding transcriptional dual regulator LrhA	DNA-Binding-Region  28->47 	FAAAAAAVCRTQSAVSQQMQ
lrp	DNA-binding transcriptional dual regulator Lrp	DNA-Binding-Region  31->50 	NVELSKRVGLSPTPCLERVR
lsrR	DNA-binding transcriptional repressor LsrR	DNA-Binding-Region  33->52 	QSEISDRLGLTRLKVSRLLE
lysR	DNA-binding transcriptional dual regulator LysR	DNA-Binding-Region  21->40 	LTEAAHLLHTSQPTVSRELA
malI	DNA-binding transcriptional repressor MalI	DNA-Binding-Region  9->28 	IHDVALAAGVSVSTVSLVLS
malT	DNA-binding transcriptional activator MalT	DNA-Binding-Region  853->872 	NEQIAGELEVAATTIKTHIR
marA	DNA-binding transcriptional dual regulator MarA	DNA-Binding-Region  29->50 	EKVSERSGYSKWHLQRMFKKET
marA	DNA-binding transcriptional dual regulator MarA	DNA-Binding-Region  77->100 	ILYLAERYGFESQQTLTRTFKNYF
matA	DNA-binding transcriptional dual regulator MatA	DNA-Binding-Region  162->181 	PKSIARIENCSVKTVYTHRR
mcbR	DNA-binding transcriptional dual regulator McbR	DNA-Binding-Region  37->56 	TKNLAEQLGMSITPVREALL
melR	DNA-binding transcriptional dual regulator MelR	DNA-Binding-Region  211->232 	NDVAEHVKLNANYAMGIFQRVM
melR	DNA-binding transcriptional dual regulator MelR	DNA-Binding-Region  259->282 	ILDIALTAGFRSSSRFYSTFGKYV
metR	DNA-binding transcriptional dual regulator MetR	DNA-Binding-Region  19->38 	LAAAAATLHQTQSALSHQFS
mhpR	DNA-binding transcriptional activator MhpR	DNA-Binding-Region  34->53 	VGLLAELSGLHRTTVRRLLE
mlc	DNA-binding transcriptional repressor Mlc	DNA-Binding-Region  33->42 	RIDLSRLAQL
mlrA	DNA-binding transcriptional activator MlrA	DNA-Binding-Region  6->25 	IGEVALLCDINPVTLRAWQR
mngR	DNA-binding transcriptional repressor MngR	DNA-Binding-Region  32->51 	ESALQTEFGVSRVTVRQALR
modE	DNA-binding transcriptional dual regulator ModE	DNA-Binding-Region  33->79 	SISQGAKDAGISYKSAWDAINEMNQLSEHILVERATGGKGGGGAVLT
mqsA	antitoxin of the MqsRA toxin-antitoxin system / DNA-binding transcriptional repressor MqsA	DNA-Binding-Region  85->104 	QKEASEIFGGGVNAFSRYEK
murR	DNA-binding transcriptional dual regulator MurR	DNA-Binding-Region  37->56 	SRQMAKQLGISQSSIVKFAQ
nac	DNA-binding transcriptional dual regulator Nac	DNA-Binding-Region  18->37 	LTQAAEVLHIAQPALSQQVA
nadR	DNA-binding transcriptional repressor/NMN adenylyltransferase NadR	DNA-Binding-Region  18->37 	LQQVADASGMTKGYLSQLLN
nagC	DNA-binding transcriptional dual regulator NagC	DNA-Binding-Region  35->44 	RIQIAEQSQL
nanR	NanR	DNA-Binding-Region  58->77 	ERELMAFFNVGRPSVREALA
narL	DNA-binding transcriptional dual regulator NarL	DNA-Binding-Region  173->192 	NKMIARRLDITESTVKVHVK
narP	DNA-binding transcriptional dual regulator NarP	DNA-Binding-Region  171->190 	NKQIASVLNISEQTVKVHIR
nemR	DNA-binding transcriptional repressor NemR	DNA-Binding-Region  30->49 	GLSELLKTAEVPKGSFYHYF
nhaR	DNA-binding transcriptional activator NhaR	DNA-Binding-Region  23->42 	VVGAAEALYLTPQTITGQIR
nimR	DNA-binding transcriptional repressor NimR	DNA-Binding-Region  178->199 	GQWAGFFAMSERNLARLIVKET
nimR	DNA-binding transcriptional repressor NimR	DNA-Binding-Region  225->248 	VQKVAHTLGYDSTTAFITMFKKGL
norR	DNA-binding transcriptional dual regulator NorR	DNA-Binding-Region  479->498 	WAACARMLETDVANLHRLAK
nsrR	DNA-binding transcriptional regulator NsrR	DNA-Binding-Region  28->51 	ISEVTDVYGVSRNHMVKIINQLSR
ompR	DNA-binding transcriptional dual regulator OmpR	DNA-Binding-Region  135->234 	EAVIAFGKFKLNLGTREMFREDEPMPLTSGEFAVLKALVSHPREPLSRDKLMNLARGREYSAMERSIDVQISRLRRMVEEDPAHPRYIQTVWGLGYVFVP
oxyR	DNA-binding transcriptional dual regulator OxyR	DNA-Binding-Region  18->37 	FRRAADSCHVSQPTLSGQIR
pdeL	DNA-binding transcriptional regulator/c-di-GMP phosphodiesterase PdeL	DNA-Binding-Region  42->61 	VTEISQYRNRSAKTISHQKK
pdhR	DNA-binding transcriptional dual regulator PdhR	DNA-Binding-Region  37->56 	ERELAKQFDVSRPSLREAIQ
pgrR	DNA-binding transcriptional repressor PgrR	DNA-Binding-Region  21->40 	FTRAAARLSMAQSALSQIVR
phoB	DNA-binding transcriptional dual regulator PhoB	DNA-Binding-Region  129->227 	EEVIEMQGLSLDPTSHRVMAGEEPLEMGPTEFKLLHFFMTHPERVYSREQLLNHVWGTNVYVEDRTVDVHIRRLRKALEPGGHDRMVQTVRGTGYRFST
phoP	DNA-binding transcriptional dual regulator PhoP	DNA-Binding-Region  124->222 	SQVISLPPFQVDLSRRELSINDEVIKLTAFEYTIMETLIRNNGKVVSKDSLMLQLYPDAELRESHTIDVLMGRLRKKIQAQYPQEVITTVRGQGYLFEL
plaR	DNA-binding transcriptional repressor PlaR	DNA-Binding-Region  45->64 	LAHLSELAGLNKSTVHRLLQ
prpR	DNA-binding transcriptional dual regulator PrpR	DNA-Binding-Region  508->527 	KTAAANYLGISRTTFWRRLK
pspF	DNA-binding transcriptional dual regulator PspF	DNA-Binding-Region  302->321 	QKRAAELLGLTYHQFRALLK
punR	DNA-binding transcriptional activator PunR	DNA-Binding-Region  19->38 	FSAAAQELHRVPSAVSYTVR
purR	DNA-binding transcriptional repressor PurR	DNA-Binding-Region  4->23 	IKDVAKRANVSTTTVSHVIN
purR	DNA-binding transcriptional repressor PurR	DNA-Binding-Region  48->56 	SAVARSLKV
puuR	DNA-binding transcriptional repressor PuuR	DNA-Binding-Region  23->42 	QRRAAELSGLTHSAISTIEQ
qseB	DNA-binding transcriptional activator QseB	DNA-Binding-Region  124->218 	SNELRHGNVMLDPGKRIATLAGEPLTLKPKEFALLELLMRNAGRVLSRKLIEEKLYTWDEEVTSNAVEVHVHHLRRKLGSDFIRTVHGIGYTLGE
rbsR	DNA-binding transcriptional dual regulator RbsR	DNA-Binding-Region  4->23 	MKDVARLAGVSTSTVSHVIN
rcdA	RcdA	DNA-Binding-Region  30->49 	THRKIATLAGVPLGSMTYYF
rclR	DNA-binding transcriptional activator RclR	DNA-Binding-Region  197->218 	ESLASIAHMSRASFAQLFRDVS
rclR	DNA-binding transcriptional activator RclR	DNA-Binding-Region  245->268 	VVVIAESVGYASESSFHKAFVREF
rcsA	DNA-binding transcriptional activator RcsA	DNA-Binding-Region  155->174 	TIQISDQMNIKAKTVSSHKG
rcsB	DNA-binding transcriptional activator RcsB	DNA-Binding-Region  168->187 	VTEIAKKLNRSIKTISSQKK
rhaR	DNA-binding transcriptional activator RhaR	DNA-Binding-Region  196->217 	DKFCDEASCSERVLRQQFRQQT
rhaR	DNA-binding transcriptional activator RhaR	DNA-Binding-Region  244->267 	ISDISTECGFEDSNYFSVVFTRET
rhaS	DNA-binding transcriptional activator RhaS	DNA-Binding-Region  191->212 	DAVADQFSLSLRTLHRQLKQQT
rhaS	DNA-binding transcriptional activator RhaS	DNA-Binding-Region  239->262 	VTDIAYRCGFSDSNHFSTLFRREF
rob	DNA-binding transcriptional dual regulator Rob	DNA-Binding-Region  25->46 	DNVAAKAGYSKWHLQRMFKDVT
rob	DNA-binding transcriptional dual regulator Rob	DNA-Binding-Region  73->96 	ILDIALQYRFDSQQTFTRAFKKQF
rpoN	RNA polymerase sigma factor RpoN	DNA-Binding-Region  366->385 	VLADIAQAVEMHESTISRVT
rspR	DNA-binding transcriptional repressor RspR	DNA-Binding-Region  38->57 	EKEVSVRFNVSRQPVREAFI
rstA	DNA-binding transcriptional regulator RstA	DNA-Binding-Region  136->235 	YKALHFGTLTIDPINRVVTLANTEISLSTADFELLWELATHAGQIMDRDALLKNLRGVSYDGLDRSVDVAISRLRKKLLDNAAEPYRIKTVRNKGYLFAP
rtcR	DNA-binding transcriptional activator RtcR	DNA-Binding-Region  485->504 	KSLSAAGRQLFDVSRQGKAS
rutR	DNA-binding transcriptional dual regulator RutR	DNA-Binding-Region  39->58 	TRLEQIAELAGVSKTNLLYY
sdiA	DNA-binding transcriptional dual regulator SdiA	DNA-Binding-Region  197->216 	SAEIAMILSISENTVNFHQK
sgrR	DNA-binding transcriptional dual regulator SgrR	DNA-Binding-Region  26->49 	LNELAALLSCSRRHMRTLLNTMQD
slyA	DNA-binding transcriptional dual regulator SlyA	DNA-Binding-Region  49->72 	QIQLAKAIGIEQPSLVRTLDQLEE
soxR	DNA-binding transcriptional dual regulator SoxR	DNA-Binding-Region  14->33 	PGEVAKRSGVAVSALHFYES
soxS	DNA-binding transcriptional dual regulator SoxS	DNA-Binding-Region  25->46 	DVVAKKSGYSKWYLQRMFRTVT
soxS	DNA-binding transcriptional dual regulator SoxS	DNA-Binding-Region  73->96 	IFDIAMDLGYVSQQTFSRVFRRQF
srlR	DNA-binding transcriptional repressor SrlR	DNA-Binding-Region  20->39 	CSVEELAQYFDTTGTTIRKD
stpA	DNA-binding transcriptional repressor StpA with RNA chaperone activity	DNA-Binding-Region  112->117 	QGRTPK
sutR	DNA-binding transcriptional dual regulator SutR	DNA-Binding-Region  23->42 	LSRLAEATGVSKAMLGQIER
tdcA	DNA-binding transcriptional activator TdcA	DNA-Binding-Region  24->43 	IGSAAKELGLTQPAVSKIIN
torR	DNA-binding transcriptional dual regulator TorR	DNA-Binding-Region  132->227 	DNCYRFAGYCLNVSRHTLERDGEPIKLTRAEYEMLVAFVTNPGEILSRERLLRMLSARRVENPDLRTVDVLIRRLRHKLSADLLVTQHGEGYFLAA
treR	DNA-binding transcriptional repressor TreR	DNA-Binding-Region  7->26 	IKDIARLSGVGKSTVSRVLN
trpR	DNA-binding transcriptional repressor TrpR	DNA-Binding-Region  68->91 	QRELKNELGAGIATITRGSNSLKA
ttdR	DNA-binding transcriptional activator Dan	DNA-Binding-Region  23->42 	FSAAAATLGQTPAFVTKRIQ
uhpA	DNA-binding transcriptional activator UhpA	DNA-Binding-Region  155->174 	VKEIAAELGLSPKTVHVHRA
uidR	DNA-binding transcriptional repressor UidR	DNA-Binding-Region  33->52 	SMKAICKSCAISPGTLYHHF
ulaR	DNA-binding transcriptional repressor UlaR	DNA-Binding-Region  20->39 	VTVEKVVERLGISPATARRD
uvrY	DNA-binding transcriptional activator UvrY	DNA-Binding-Region  167->186 	VNEISEQLNLSPKTVNSYRY
uxuR	DNA-binding transcriptional repressor UxuR	DNA-Binding-Region  36->55 	EREIAEMLDVTRTVVREALI
xapR	DNA-binding transcriptional activator XapR	DNA-Binding-Region  24->43 	FGRAAARLNMSQPPLSIHIK
xylR	DNA-binding transcriptional dual regulator XylR	DNA-Binding-Region  305->326 	DQVLDAVGISRSNLEKRFKEEV
xylR	DNA-binding transcriptional dual regulator XylR	DNA-Binding-Region  353->376 	INEISQMCGYPSLQYFYSVFKKAY
xynR	CP4-6 prophage; DNA-binding transcriptional repressor XynR	DNA-Binding-Region  25->45 	KITDISKLMGLSKSTLHSLLK
yciT	DNA-binding transcriptional dual regulator YciT	DNA-Binding-Region  18->37 	VSVTDLAKATGVSEVTIRQD
ycjW	DNA-binding transcriptional repressor YcjW	DNA-Binding-Region  5->24 	IYDIARVAGVSKSTVSRVLN
ydcI	DNA-binding transcriptional dual regulator YdcI	DNA-Binding-Region  28->47 	LGRAAETLNLSQPALSKTLN
ydeO	DNA-binding transcriptional dual regulator YdeO	DNA-Binding-Region  154->175 	KDICDCLYISESLLKKKLKQEQ
ydeO	DNA-binding transcriptional dual regulator YdeO	DNA-Binding-Region  200->223 	VNKIAEQCGYASTSYFIYAFRKHF
yebK	DNA-binding transcriptional repressor YebK	DNA-Binding-Region  37->56 	IAAMALEANVSEPTVNRFCR
yeiL	DNA-binding transcriptional activator YeiL	DNA-Binding-Region  158->181 	KHTQAAEYLGVSYRHLLYVLAQFI
ygbI	DNA-binding transcriptional repressor YgbI	DNA-Binding-Region  20->39 	VSIAELTDRMNVSHMTIRRD
yhaJ	DNA-binding transcriptional activator YhaJ	DNA-Binding-Region  24->43 	FAAAADELGRVPSALSYTMQ
yidZ	DNA-binding transcriptional dual regulator YidZ	DNA-Binding-Region  25->44 	VTKAAKRINVTPSAVSKSLA
yjjQ	DNA-binding transcriptional repressor YjjQ	DNA-Binding-Region  171->190 	INQIASLLKKSNKTISAQKN
yqhC	DNA-binding transcriptional activator YqhC	DNA-Binding-Region  230->251 	EQLAAEANMSVSAFHHNFKSVT
yqhC	DNA-binding transcriptional activator YqhC	DNA-Binding-Region  278->301 	ASAAAMRVGYESASQFSREFKRYF
zntR	DNA-binding transcriptional activator ZntR	DNA-Binding-Region  4->23 	IGELAKMAEVTPDTIRYYEK
zraR	DNA-binding transcriptional activator ZraR	DNA-Binding-Region  421->440 	KTEAARQLGITRKTLLAKLS
